		
		
		
man_0	man-0	man_0
		
		
		
		
		
man_1	man-1	man_1
		
		
		
		
		
man_2	man-2	man_2
		
		
		
		
		
man_3	man-3	man_3
		
		
		
		
		
man_4	man-4	man_4
		
		
		
		
		
		
		
		
		
father_0;man_5	father-0 man-5	father_0_man_5
		
		
		
		
		
		
		
cat_0	cat-0	cat_0
		
		
		
		
		
cat_1	cat-1	cat_1
		
		
		
		
		
		
		
		
dog_0;father_1	dog-0 father-1	dog_0_father_1
		
		
		
		
		
		
		
		
bag_0	bag-0	bag_0
		
		
		
		
		
		
		
		
want_0;woman_0	want-0 woman-0	want_0_woman_0
		
		
		
		
		
		
		
		
house_0	house-0	house_0
		
		
		
		
		
want_1;house_1	want-1 house-1	want_1_house_1
		
		
		
		
		
		
		
		
		
		
		
		
		
		
		
question_0;woman_0;man_0;men_0;want_2	question-0 woman-0 man-0 men-0 want-2	question_0_woman_0_man_0_men_0_want_2
		
		
		
		
		
		
		
		
		
		
		
		
		
		
		
		
		
		
		
		
		
		
		
		
		
question_0	question-0	question_0
		
		
		
want_2	want-2	want_2
		
		
		
		
		
pronoun_0	pronoun-0	pronoun_0
		
		
		
		
eat_0;food_0	eat-0 food-0	eat_0_food_0
		
		
		
		
		
eat_1	eat-1	eat_1
		
		
		
		
		
		
		
question_0	question-0	question_0
		
		
		
		
		
question_0;man_0;woman_0;men_0	question-0 man-0 woman-0 men-0	question_0_man_0_woman_0_men_0
		
		
		
		
		
		
pronoun_0	pronoun-0	pronoun_0
		
		
		
		
		
		
		
		
speak_0;man_0;woman_0;people_0	speak-0 man-0 woman-0 people-0	speak_0_man_0_woman_0_people_0
		
		
		
		
		
		
no_speak_0	no-speak-0	no_speak_0
		
		
		
		
		
		
		
		
		
		
name_0;what_0	name-0 what-0	name_0_what_0
		
		
		
		
		
		
		
		
		
name_0; address_0;woman_0; people_0	name-0 address-0 woman-0 people-0	name_0_address_0_woman_0_people_0
		
		
		
		
		
		
		
		
know_0	know-0	know_0
		
		
		
		
		
		
		
		
		
		
pronoun_0;father_0;mother_0;people_0	pronoun-0 father-0 mother-0 people-0	pronoun_0_father_0_mother_0_people_0
		
		
		
		
		
		
		
		
		
		
		
problem_0	problem-0	problem_0
		
		
		
		
		
		
		
		
house_0;car_0;cat_0	house-0 car-0 cat-0	house_0_car_0_cat_0
		
		
		
		
have_0	have-0	have_0
		
		
		
		
		
have_1	have-1	have_1
		
		
		
		
		
		
		
		
		
		
		
		
		
		
		
		
		
		
		
		
		
		
		
		
		
		
		
question_0	question-0	question_0
		
		
		
		
		
		
		
		
		
		
		
		
		
		
		
		
		
		
		
		
		
		
		
		
		
		
		
		
		
		
a_problem	a-problem	a_problem
		
		
		
		
		
		
		
		
		
		
		
		
		
		
		
		
		
		
		
		
		
		
		
		
		
		
imperative_0	imperative-0	imperative_0
		
		
		
		
		
		
		
		
		
		
		
		
		
		
what_0	what-0	what_0
		
		
		
		
		
		
		
		
		
		
		
		
		
		
		
		
		
		
		
		
		
		
		
		
		
		
		
		
		
		
		
		
		
		
		
		
		
		
		
		
		
		
		
		
		
		
		
		
		
		
		
		
		
		
		
		
		
		
		
		
		
		
		
		
		
		
		
		
		
		
		
		
		
		
		
		
		
		
		
		
		
		
		
		
		
		
		
		
		
		
		
		
		
		
		
		
		
		
		
		
		
		
		
		
		
		
		
		
		
		
		
		
		
		
		
		
		
		
		
		
		
		
		
		
		
		
		
		
		
		
		
		
		
		
		
		
		
		
		
		
		
		
		
		
		
		
		
		
		
		
		
		
		
		
		
		
		
		
		
		
		
		
		
		
		
		
		
		
		
		
		
		
		
		
		
		
		
		
		
		
		
		
		
		
		
		
		
		
		
		
		
		
		
		
		
		
		
		
		
		
		
		
		
		
		
		
		
		
		
		
		
		
		
		
		
		
		
		
		
		
		
		
		
		
		
		
		
		
		
		
		
		
		
		
		
		
		
		
		
		
		
		
		
		
		
		
		
		
		
		
		
		
		
		
		
		
		
		
		
		
		
		
		
		
		
		
		
		
		
		
		
		
		
		
		
		
		
		
		
		
		
		
		
		
		
		
		
		