一個男人	一個男人	一個男人
男人	男人	男人
{這個男人}	這個男人	這個男人
他很聰明	他很聰明	他很聰明
這個 男人 很 聰明	這個 男人 很 聰明	這個_男人_很_聰明
他 很 好	他 很 好	他_很_好
這個 男人 很 好	這個 男人 很 好	這個_男人_很_好
他很高	他很高	他很高
這個男子很高	這個男子很高	這個男子很高
一個聰明的人	一個聰明的人	一個聰明的人
這個 聰明 的 男人	這個 聰明 的 男人	這個_聰明_的_男人
一個 好 男人	一個 好 男人	一個_好_男人
這個 好 男人	這個 好 男人	這個_好_男人
一個高的男子	一個高的男子	一個高的男子
這個高的男人	這個高的男人	這個高的男人
他 讀	他 讀	他_讀
這個 男人 讀	這個 男人 讀	這個_男人_讀
他 吃	他 吃	他_吃
這個  男人 吃	這個 男人 吃	這個_男人_吃
他 喝	他 喝	他_喝
這個  男人 喝	這個 男人 喝	這個_男人_喝
他 唱	他 唱	他_唱
唱 的 男人	唱 的 男人	唱_的_男人
他 煮	他 煮	他_煮
煮 的 男人	煮 的 男人	煮_的_男人
他 游泳	他 游泳	他_游泳
游泳 的 男人	游泳 的 男人	游泳_的_男人
他 是 一個 老師	他 是 一個 老師	他_是_一個_老師
這個 男人 是 一個 老師	這個 男人 是 一個 老師	這個_男人_是_一個_老師
他 是 一個 醫生	他 是 一個 醫生	他_是_一個_醫生
這個 男人 是 一個 醫生	這個 男人 是 一個 醫生	這個_男人_是_一個_醫生
他 是 一個 翻譯	他 是 一個 翻譯	他_是_一個_翻譯
這個 男人 是 一個 翻譯	這個 男人 是 一個 翻譯	這個_男人_是_一個_翻譯
我 的 父親	我 的 父親	我_的_父親
他 的 父親	他 的 父親	他_的_父親
她 的 父親	她 的 父親	她_的_父親
你 的 父親（s）%，你們 的 父親（p） % 您 的 父親 (r)	你 的 父親 s%你們 的 父親 p%您 的 父親	你_的_父親_s%你們_的_父親_p%您_的_父親_r
我 的 父親 是 一個 老師	我 的 父親 是 一個 老師	我_的_父親_是_一個_老師
他 的 父親 是 一個 醫生	他 的 父親 是 一個 醫生	他_的_父親_是_一個_醫生
她 的 父親 是 一個 翻譯	她 的 父親 是 一個 翻譯	她_的_父親_是_一個_翻譯
我 的 父親 是 一個 醫生	我 的 父親 是 一個 醫生	我_的_父親_是_一個_醫生
你 的 父親 是 一個 老師（s）% 你們 的 父親 是 一個 老師（p）%  您 的 父親 是 一個 老師 (r)	你 的 父親 是 一個 老師 s%你們 的 父親 是 一個 老師 p%您 的 父親 是 一個 老師	你_的_父親_是_一個_老師_s%你們_的_父親_是_一個_老師_p%您_的_父親_是_一個_老師_r
一個貓	一個貓	一個貓
貓	貓	貓
這個 貓	這個 貓	這個_貓
我 的 貓	我 的 貓	我_的_貓
你 的 貓（s）%，你們 的 貓（p）%  您 的 貓 (r)	你 的 貓 s%你們 的 貓 p%您 的 貓	你_的_貓_s%你們_的_貓_p%您_的_貓_r
我們 的 貓	我們 的 貓	我們_的_貓
他 的 貓	他 的 貓	他_的_貓
她 的 貓	她 的 貓	她_的_貓
他們 的 貓	他們 的 貓	他們_的_貓
一個 大 貓	一個 大 貓	一個_大_貓
我 的 貓 是 大	我 的 貓 是 大	我_的_貓_是_大
一個  黑 貓	一個 黑 貓	一個_黑_貓
他 的 貓 是 黑色	他 的 貓 是 黑色	他_的_貓_是_黑色
小貓	小貓	小貓
她 的 貓 是 小	她 的 貓 是 小	她_的_貓_是_小
一個狗	一個狗	一個狗
狗	狗	狗
這個 狗	這個 狗	這個_狗
我 的 狗	我 的 狗	我_的_狗
我 父親 的 狗	我 父親 的 狗	我_父親_的_狗
他 的 狗	他 的 狗	他_的_狗
他 父親 的 狗	他 父親 的 狗	他_父親_的_狗
她 的 狗	她 的 狗	她_的_狗
她 父親 的 狗	她 父親 的 狗	她_父親_的_狗
一個 包包	一個 包包	一個_包包
包包	包包	包包
這個 包包	這個 包包	這個_包包
我要一個包包	我要一個包包	我要一個包包
他要一個背包	他要一個背包	他要一個背包
我要一個車	我要一個車	我要一個車
他要一個車	他要一個車	他要一個車
我要一個房子	我要一個房子	我要一個房子
他 要 一個 房子	他 要 一個 房子	他_要_一個_房子
一個女人	一個女人	一個女人
女人	女人	女人
{這個女人}	這個女人	這個女人
她要一個車	她要一個車	她要一個車
這個女人要一個車	這個女人要一個車	這個女人要一個車
她 要 一個 包包	她 要 一個 包包	她_要_一個_包包
這個女人要一個包包	這個女人要一個包包	這個女人要一個包包
她要一個房子	她要一個房子	她要一個房子
這個 女人 要 一個 房子	這個 女人 要 一個 房子	這個_女人_要_一個_房子
一個 房子	一個 房子	一個_房子
房子	房子	房子
這個 房子	這個 房子	這個_房子
{一個[新](房子)}	一個 新	一個_新_房子
這個 房子 是 新 的	這個 房子 是 新 的	這個_房子_是_新_的
{一個[舊]房子}	一個 舊 房子	一個_舊_房子
這個  房子 是 舊 的	這個 房子 是 舊 的	這個_房子_是_舊_的
一個 好 的 房子	一個 好 的 房子	一個_好_的_房子
這個 房子 是 好 的	這個 房子 是 好 的	這個_房子_是_好_的
我們要一個房子	我們要一個房子	我們要一個房子
我們 要 一個 新 的 房子	我們 要 一個 新 的 房子	我們_要_一個_新_的_房子
他們 要 一個 房子	他們 要 一個 房子	他們_要_一個_房子
他們 要 一個 新 的 房子	他們 要 一個 新 的 房子	他們_要_一個_新_的_房子
我們 要 一個 好 的 房子	我們 要 一個 好 的 房子	我們_要_一個_好_的_房子
他們 要 一個 好 的 房子	他們 要 一個 好 的 房子	他們_要_一個_好_的_房子
什麼?	什麼	什麼
哪裡?	哪裡	哪裡
幾點?	幾點	幾點
誰?	誰	誰
為什麼?	為什麼	為什麼
怎麼樣?	怎麼樣	怎麼樣
多少?	多少	多少
男人	男人	男人
男人	男人	男人
這些 男人	這些 男人	這些_男人
你 要 什麼（s）% 你們 要 什麼 （p）% 您 要 什麼 (r)	你 要 什麼 s%你們 要 什麼 p%您 要 什麼	你_要_什麼_s%你們_要_什麼_p%您_要_什麼_r
她 要 什麼	她 要 什麼	她_要_什麼
這個 女人 要 什麼	這個 女人 要 什麼	這個_女人_要_什麼
他 要 什麼	他 要 什麼	他_要_什麼
這個 男人 要 什麼	這個 男人 要 什麼	這個_男人_要_什麼
他們 要 什麼	他們 要 什麼	他們_要_什麼
這些 男人 要 什麼	這些 男人 要 什麼	這些_男人_要_什麼
湯	湯	湯
飯	飯	飯
麵	麵	麵
麵包	麵包	麵包
沙拉	沙拉	沙拉
起司	起司	起司
雞	雞	雞
肉	肉	肉
蔬菜	蔬菜	蔬菜
魚	魚	魚
水果	水果	水果
豬肉	豬肉	豬肉
他	他	他
她	她	她
我	我	我
我們	我們	我們
他們	他們	他們
你 (s) % 你們 (p) % 您 (r)	你%你們%您	你_s%你們_p%您_r
他	他	他
這 是 什麼	這 是 什麼	這_是_什麼
怎 樣 了	怎 樣 了	怎_樣_了
還 有 什麼	還 有 什麼	還_有_什麼
怎麼了	怎麼了	怎麼了
我 要 吃	我 要 吃	我_要_吃
她 要 吃	她 要 吃	她_要_吃
我 要 喝	我 要 喝	我_要_喝
她 要 喝	她 要 喝	她_要_喝
我 要 讀	我 要 讀	我_要_讀
她 要 讀	她 要 讀	她_要_讀
我 吃	我 吃	我_吃
我們 吃	我們 吃	我們_吃
她 吃	她 吃	她_吃
你 吃（S）％，你們 吃（P）% 您 吃 (r)	你 吃 s 你們 吃 p%您 吃	你_吃_s_你們_吃_p%您_吃_r
他們 吃	他們 吃	他們_吃
我吃麵食	我吃麵食	我吃麵食
他 吃 麵	他 吃 麵	他_吃_麵
她 吃 水果	她 吃 水果	她_吃_水果
我們 吃 魚	我們 吃 魚	我們_吃_魚
他們 吃 起司	他們 吃 起司	他們_吃_起司
你 吃 雞肉（P）％你們 吃 雞肉（P）% 您 吃 雞肉 (r)	你 吃 雞肉 p 你們 吃 雞肉 p%您 吃 雞肉	你_吃_雞肉_p_你們_吃_雞肉_p%您_吃_雞肉_r
我 不 吃 肉	我 不 吃 肉	我_不_吃_肉
她 不 吃 肉	她 不 吃 肉	她_不_吃_肉
我 不 吃 豬肉	我 不 吃 豬肉	我_不_吃_豬肉
她 不 吃 豬肉	她 不 吃 豬肉	她_不_吃_豬肉
他們 不 吃 魚	他們 不 吃 魚	他們_不_吃_魚
他們 不 吃 起司	他們 不 吃 起司	他們_不_吃_起司
他 不 吃 麵	他 不 吃 麵	他_不_吃_麵
他 不 吃 水果	他 不 吃 水果	他_不_吃_水果
你 做 什麼 （s）％ 你們 做 什麼 （p）% 您 做 什麼 (r)	你 做 什麼 s 你們 做 什麼 p%您 做 什麼	你_做_什麼_s_你們_做_什麼_p%您_做_什麼_r
你 說 什麼 (s）％ 你們 說 什麼（p）% 您 什麼 (r)	你 說 什麼 s 你們 說 什麼 p%您 什麼	你_說_什麼_s_你們_說_什麼_p%您_什麼_r
她 做 什麼	她 做 什麼	她_做_什麼
她 說 什麼	她 說 什麼	她_說_什麼
他 做 什麼	他 做 什麼	他_做_什麼
他 說 什麼	他 說 什麼	他_說_什麼
你 是 誰 （s）％你們 是 誰 （p） %  您 是 誰 (r)	你 是 誰 s 你們 是 誰 p%您 是 誰	你_是_誰_s_你們_是_誰_p%您_是_誰_r
他 是 誰	他 是 誰	他_是_誰
誰 是 這個 男人	誰 是 這個 男人	誰_是_這個_男人
她 是 誰	她 是 誰	她_是_誰
誰 是 這個 女人	誰 是 這個 女人	誰_是_這個_女人
他們 是 誰	他們 是 誰	他們_是_誰
誰 是 這些 男人	誰 是 這些 男人	誰_是_這些_男人
我 說 英語	我 說 英語	我_說_英語
她 說 英語	她 說 英語	她_說_英語
我們 說 英語	我們 說 英語	我們_說_英語
他們 說 英語	他們 說 英語	他們_說_英語
你 說 英語（s）％ 你們 說 英語（p）% 您 說 英語 (r)	你 說 英語 s 你們 說 英語 p%您 說 英語	你_說_英語_s_你們_說_英語_p%您_說_英語_r
他 說 英語	他 說 英語	他_說_英語
人	人	人
人	人	人
這些 人	這些 人	這些_人
我 不 說 英語	我 不 說 英語	我_不_說_英語
她 不 說 英語	她 不 說 英語	她_不_說_英語
這個 女人 不 說 英語	這個 女人 不 說 英語	這個_女人_不_說_英語
他 不 說 英語	他 不 說 英語	他_不_說_英語
這個 男人 不 說 英語	這個 男人 不 說 英語	這個_男人_不_說_英語
他們 不 說 英語	他們 不 說 英語	他們_不_說_英語
這些 人 不 說 英語	這些 人 不 說 英語	這些_人_不_說_英語
你 說 英語 嗎 (s) % 你們 說 英語 嗎 (p) % 您 說 英語 嗎 (r)	你 說 英語 嗎%你們 說 英語 嗎%您 說 英語 嗎	你_說_英語_嗎_s%你們_說_英語_嗎_p%您_說_英語_嗎_r
她 說 英語 嗎	她 說 英語 嗎	她_說_英語_嗎
這個 女人 說 英語 嗎	這個 女人 說 英語 嗎	這個_女人_說_英語_嗎
他 說 英語 嗎	他 說 英語 嗎	他_說_英語_嗎
這個 男人 說 英語 嗎	這個 男人 說 英語 嗎	這個_男人_說_英語_嗎
他們  說 英語 嗎	他們 說 英語 嗎	他們_說_英語_嗎
這些 人 說 英語 嗎	這些 人 說 英語 嗎	這些_人_說_英語_嗎
我 的 名字	我 的 名字	我_的_名字
他 的 名字	他 的 名字	他_的_名字
她 的 名字	她 的 名字	她_的_名字
你 的 名字 (s) % 你們 的 名字 (p) % 您 的 名字 (r)	你 的 名字%你們 的 名字%您 的 名字	你_的_名字_s%你們_的_名字_p%您_的_名字_r
你 的 名字 是 什麽 (s) % 你們 的 名字 是 什麽 (p) % 您 的 名字 是 什麽 (r)	你 的 名字 是 什麽%你們 的 名字 是 什麽%您 的 名字 是 什麽	你_的_名字_是_什麽_s%你們_的_名字_是_什麽_p%您_的_名字_是_什麽_r
他 的 名字 是 什麽	他 的 名字 是 什麽	他_的_名字_是_什麽
她 的 名字 是 什麽	她 的 名字 是 什麽	她_的_名字_是_什麽
地址	地址	地址
我 的 地址	我 的 地址	我_的_地址
你  的 地址（s）％ 你們  的 地址 (p) % 您  的 地址 (r)	你 的 地址 s 你們 的 地址%您 的 地址	你_的_地址_s_你們_的_地址_p%您_的_地址_r
他 的 地址	他 的 地址	他_的_地址
她 的 地址	她 的 地址	她_的_地址
我們 的 地址	我們 的 地址	我們_的_地址
他們 的 地址	他們 的 地址	他們_的_地址
我 知道 他 的 名字	我 知道 他 的 名字	我_知道_他_的_名字
我 知道 他 的 地址	我 知道 他 的 地址	我_知道_他_的_地址
他 知道 我 的 地址	他 知道 我 的 地址	他_知道_我_的_地址
他 知道 我 的 名字	他 知道 我 的 名字	他_知道_我_的_名字
她 知道 他們 的 地址	她 知道 他們 的 地址	她_知道_他們_的_地址
她 知道 他 的 名字	她 知道 他 的 名字	她_知道_他_的_名字
這個 女人 知道 我 的 地址	這個 女人 知道 我 的 地址	這個_女人_知道_我_的_地址
他們 知道 我們 的 地址	他們 知道 我們 的 地址	他們_知道_我們_的_地址
這些 人 知道 他 的 名字	這些 人 知道 他 的 名字	這些_人_知道_他_的_名字
我 不 知道	我 不 知道	我_不_知道
他 不 知道	他 不 知道	他_不_知道
這個 男人 不 知道	這個 男人 不 知道	這個_男人_不_知道
她 不 知道	她 不 知道	她_不_知道
這個 女人 不 知道	這個 女人 不 知道	這個_女人_不_知道
他們 不 知道	他們 不 知道	他們_不_知道
這些 人 不 知道	這些 人 不 知道	這些_人_不_知道
我 的 母親	我 的 母親	我_的_母親
你 的 母親（s）％你們 的 母親（p）% 您 的 母親 (r)	你 的 母親 s 你們 的 母親 p%您 的 母親	你_的_母親_s_你們_的_母親_p%您_的_母親_r
他 的
 母親	他 的 母親	他_的_母親
她 的 母親	她 的 母親	她_的_母親
我 會 游泳	我 會 游泳	我_會_游泳
他 會 游泳	他 會 游泳	他_會_游泳
我 的 父親 會 游泳	我 的 父親 會 游泳	我_的_父親_會_游泳
她 會 游泳	她 會 游泳	她_會_游泳
我 的 母親 會 游泳	我 的 母親 會 游泳	我_的_母親_會_游泳
你 會 游泳（s）％你們 會 游泳（p）% 您 會 游泳 (r)	你 會 游泳 s 你們 會 游泳 p%您 會 游泳	你_會_游泳_s_你們_會_游泳_p%您_會_游泳_r
我們 會 游泳	我們 會 游泳	我們_會_游泳
他們 會 游泳	他們 會 游泳	他們_會_游泳
這些 人 會 游泳	這些 人 會 游泳	這些_人_會_游泳
一個 問題	一個 問題	一個_問題
問題	問題	問題
這個 問題	這個 問題	這個_問題
我 的 問題	我 的 問題	我_的_問題
他
 的 問題	他 的 問題	他_的_問題
她 的 問題	她 的 問題	她_的_問題
你 的 問題（s）％你們 的 問題 (p) % 您 的 問題（r）	你 的 問題 s 你們 的 問題%您 的 問題 r	你_的_問題_s_你們_的_問題_p%您_的_問題_r
我們 的 問題	我們 的 問題	我們_的_問題
他們 的 問題	他們 的 問題	他們_的_問題
一個汽車	一個汽車	一個汽車
這個 車	這個 車	這個_車
這個 車	這個 車	這個_車
我 有 一個 房子	我 有 一個 房子	我_有_一個_房子
我 有 一個 車	我 有 一個 車	我_有_一個_車
他 有 一個 房子	他 有 一個 房子	他_有_一個_房子
他 有 一個 車	他 有 一個 車	他_有_一個_車
她有一個貓	她有一個貓	她有一個貓
他 有 一個 房子	他 有 一個 房子	他_有_一個_房子
他 有 一個 貓	他 有 一個 貓	他_有_一個_貓
他們 有 一個 車	他們 有 一個 車	他們_有_一個_車
他們 有 一個 房子	他們 有 一個 房子	他們_有_一個_房子
我們有一個貓	我們有一個貓	我們有一個貓
我們 有 一個 房子	我們 有 一個 房子	我們_有_一個_房子
我 没 有 一個 房子	我 没 有 一個 房子	我_没_有_一個_房子
我 没 有 一個 車	我 没 有 一個 車	我_没_有_一個_車
他 没 有 一個 房子	他 没 有 一個 房子	他_没_有_一個_房子
她 没 有 一個 車	她 没 有 一個 車	她_没_有_一個_車
她 没 有 一個 貓	她 没 有 一個 貓	她_没_有_一個_貓
他 没 有 一個 房子	他 没 有 一個 房子	他_没_有_一個_房子
他 没 有 一個 貓	他 没 有 一個 貓	他_没_有_一個_貓
他們 没 有 一個 車	他們 没 有 一個 車	他們_没_有_一個_車
他們 没 有 一個 房子	他們 没 有 一個 房子	他們_没_有_一個_房子
我們 没 有 一個 貓	我們 没 有 一個 貓	我們_没_有_一個_貓
我們 没 有 一個 房子	我們 没 有 一個 房子	我們_没_有_一個_房子
真 的 嗎	真 的 嗎	真_的_嗎
確定 嗎	確定 嗎	確定_嗎
你 呢? (s) % 你們 呢 (p) % 您 呢 (r)	你 呢%你們 呢%您 呢	你_呢_s%你們_呢_p%您_呢_r
完 了 嗎	完 了 嗎	完_了_嗎
對 嗎	對 嗎	對_嗎
早安	早安	早安
晚安	晚安	晚安
你 好 （s）％ 你們 好（p）% 您 好 (r)	你 好 s 你們 好 p%您 好	你_好_s_你們_好_p%您_好_r
歡迎	歡迎	歡迎
謝謝	謝謝	謝謝
不 客氣	不 客氣	不_客氣
抱歉	抱歉	抱歉
對不起！	對不起	對不起
沒關係	沒關係	沒關係
再見	再見	再見
這 給 你  (s) % 這 給 你們 (p) % 這 給 您 (r)	這 給 你%這 給 你們%這 給 您	這_給_你_s%這_給_你們_p%這_給_您_r
“請	請	請
你 從 哪裡 來 (s) % 你們 從 哪裡 來 (p) % 您 從 哪裡 來 (r)	你 從 哪裡 來%你們 從 哪裡 來%您 從 哪裡 來	你_從_哪裡_來_s%你們_從_哪裡_來_p%您_從_哪裡_來_r
你 在 哪裡 (s) % 你們 在 那裡 (p) % 您 在 那裡 (r)	你 在 哪裡%你們 在 那裡%您 在 那裡	你_在_哪裡_s%你們_在_那裡_p%您_在_那裡_r
他 在 那裡	他 在 那裡	他_在_那裡
她 在 那裡	她 在 那裡	她_在_那裡
我們 在 那裡	我們 在 那裡	我們_在_那裡
他們 在 那裡	他們 在 那裡	他們_在_那裡
我在那裡?	我在那裡	我在那裡
現在	現在	現在
今天	今天	今天
明天	明天	明天
昨天	昨天	昨天
過一會兒	過一會兒	過一會兒
下個 星期	下個 星期	下個_星期
上個 星期	上個 星期	上個_星期
下個 月	下個 月	下個_月
上個 月	上個 月	上個_月
有時	有時	有時
總是	總是	總是
常常	常常	常常
很少	很少	很少
對	對	對
不	不	不
當然	當然	當然
不 確定	不 確定	不_確定
還沒	還沒	還沒
有 可能	有 可能	有_可能
好	好	好
我 不 覺得	我 不 覺得	我_不_覺得
不 知道	不 知道	不_知道
沒 問題	沒 問題	沒_問題
隨便	隨便	隨便
有 一個 問題	有 一個 問題	有_一個_問題
有 一個 問題	有 一個 問題	有_一個_問題
暴風雨	暴風雨	暴風雨
有 暴風雨	有 暴風雨	有_暴風雨
一個 主意	一個 主意	一個_主意
另外 一個 主意	另外 一個 主意	另外_一個_主意
一個火車	一個火車	一個火車
另外 一個 火車	另外 一個 火車	另外_一個_火車
一個 電影	一個 電影	一個_電影
另外 一個 電影	另外 一個 電影	另外_一個_電影
男孩	男孩	男孩
一些 男孩	一些 男孩	一些_男孩
女孩	女孩	女孩
一些 女孩	一些 女孩	一些_女孩
車	車	車
一些 車	一些 車	一些_車
有人	有人	有人
某物	某物	某物
沒有人	沒有人	沒有人
沒什麼	沒什麼	沒什麼
大家	大家	大家
一切	一切	一切
等等	等等	等等
來	來	來
走	走	走
留著	留著	留著
離開	離開	離開
看	看	看
聽	聽	聽
記住	記住	記住
讀	讀	讀
看	看	看
抓住	抓住	抓住
我 愛 你	我 愛 你	我_愛_你
他 愛 她	他 愛 她	他_愛_她
她 愛 他	她 愛 他	她_愛_他
他們 愛 她	他們 愛 她	他們_愛_她
這些 人 愛 她	這些 人 愛 她	這些_人_愛_她
這些 人 愛 他	這些 人 愛 他	這些_人_愛_他
我們 愛 他	我們 愛 他	我們_愛_他
他 愛 他們	他 愛 他們	他_愛_他們
這些 人 愛 他們	這些 人 愛 他們	這些_人_愛_他們
		
		
		
		
		
		
		
		
		
		
		
		
		
		
		
		
		
		
		
		
		
		
		
		
		
		
		
		
		
		
		
		
		
		
		
		
		
		
		
		
		
		
		
		
		
一個高的老師	一個高的老師	一個高的老師
一個聰明的老師	一個聰明的老師	一個聰明的老師
聰明的老師	聰明的老師	聰明的老師
高的男人	高的男人	高的男人
這個聰明的老師	這個聰明的老師	這個聰明的老師
這個老師很聰明	這個老師很聰明	這個老師很聰明
這個高的老師	這個高的老師	這個高的老師
這個老師很高	這個老師很高	這個老師很高
這個高的老師很聰明	這個高的老師很聰明	這個高的老師很聰明
這個聰明的男子很高	這個聰明的男子很高	這個聰明的男子很高
早安！ <br> 早安。	早安 br 早安	早安_br_早安
晚安！ <br> 晚安。	晚安 br 晚安	晚安_br_晚安
你好嗎？ <br> 我好，謝謝。	你好嗎 br 我好 謝謝	你好嗎_br_我好_謝謝
謝謝！ <br> 不客氣。	謝謝 br 不客氣	謝謝_br_不客氣
你的名字是什麼？ <br>我的名字是Adam。	你的名字是什麼 br 我的名字是adam	你的名字是什麼_br_我的名字是adam
一個公共汽車	一個公共汽車	一個公共汽車
一個飛機	一個飛機	一個飛機
一個船	一個船	一個船
我有一個狗	我有一個狗	我有一個狗
我有一個貓	我有一個貓	我有一個貓
我有一個馬	我有一個馬	我有一個馬
我們有一個馬	我們有一個馬	我們有一個馬
她有一個狗	她有一個狗	她有一個狗
他有一個狗	他有一個狗	他有一個狗
他有一個馬	他有一個馬	他有一個馬
這個老師有一個馬	這個老師有一個馬	這個老師有一個馬
這個老師有一個狗	這個老師有一個狗	這個老師有一個狗
你有一個狗	你有一個狗	你有一個狗
你有一個貓	你有一個貓	你有一個貓
一個魚	一個魚	一個魚
一個牛	一個牛	一個牛
一個鳥	一個鳥	一個鳥
你从哪裡来？ <BR> 我从法國來。	你从哪裡来 br 我从法國來	你从哪裡来_br_我从法國來
你你幾歲？ <BR>我二十歲。	你你幾歲 br 我二十歲	你你幾歲_br_我二十歲
你要什麼？ <BR> 我想吃飯。	你要什麼 br 我想吃飯	你要什麼_br_我想吃飯
你在找什麼？ <BR>我在找餐廳。	你在找什麼 br 我在找餐廳	你在找什麼_br_我在找餐廳
一個男孩	一個男孩	一個男孩
一個女孩	一個女孩	一個女孩
我們要一個車	我們要一個車	我們要一個車
這個男人要一個房子	這個男人要一個房子	這個男人要一個房子
這個男人要一個車	這個男人要一個車	這個男人要一個車
你要一個車	你要一個車	你要一個車
你要一個房子	你要一個房子	你要一個房子
{一個[小](問題)}	一個 小	一個_小_問題
{一個[大](問題)}	一個 大	一個_大_問題
{[另外]一個問題}	另外 一個問題	另外_一個問題
{一個[大](房子)}	一個 大	一個_大_房子
{[其他](問題)}	其他	其他_問題
{[好]的問題}	好 的問題	好_的問題
{[許多]問題}	許多 問題	許多_問題
[一個舊車]	一個舊車	一個舊車
[一個好車]	一個好車	一個好車
{一個[新](車)}	一個 新	一個_新_車
{這個人}	這個人	這個人
{我的[電話](號碼)}	我的 電話	我的_電話_號碼
{我[新]的(地址)}	我 新 的	我_新_的_地址
{我的[護照]}	我的 護照	我的_護照
信來了	信來了	信來了
人來了	人來了	人來了
客人來了	客人來了	客人來了
他想要一張票	他想要一張票	他想要一張票
我吃雞	我吃雞	我吃雞
我吃奶酪	我吃奶酪	我吃奶酪
我看到公共汽車了	我看到公共汽車了	我看到公共汽車了
我看到火車了	我看到火車了	我看到火車了
我看到飛機了	我看到飛機了	我看到飛機了
我有{一個[小](問題)}	我有 一個 小	我有_一個_小_問題
我們有{一個[大](問題)}	我們有 一個 大	我們有_一個_大_問題
他有{[另外]一個問題}	他有 另外 一個問題	他有_另外_一個問題
我們有{一個[大](房子)}	我們有 一個 大	我們有_一個_大_房子
她有{一个[新](房子)}	她有 一个 新	她有_一个_新_房子
他們有{一個[舊]房子}	他們有 一個 舊 房子	他們有_一個_舊_房子
你有{[其他](問題)}	你有 其他	你有_其他_問題
他們有{[好]的問題}	他們有 好 的問題	他們有_好_的問題
我們有{[許多]問題}	我們有 許多 問題	我們有_許多_問題
{這個(女人)}有一個新[廚房]	這個 有一個新 廚房	這個_女人_有一個新_廚房
{這個(男人)}有[一個舊車]	這個 有 一個舊車	這個_男人_有_一個舊車
{這個(人)}有[一個好車]	這個 有 一個好車	這個_人_有_一個好車
他沒有{一個[新](車)}	他沒有 一個 新	他沒有_一個_新_車
他們沒有{[其他]的(問題)}	他們沒有 其他 的	他們沒有_其他_的_問題
我們沒有{[任何]問題}	我們沒有 任何 問題	我們沒有_任何_問題
{這個女人}沒有[一個好車]	這個女人 沒有 一個好車	這個女人_沒有_一個好車
{這個男人}沒有[一個舊車]	這個男人 沒有 一個舊車	這個男人_沒有_一個舊車
{這個人}沒有[一個新車]	這個人 沒有 一個新車	這個人_沒有_一個新車
我是{[新來]的(老師)}	我是 新來 的	我是_新來_的_老師
我是{[新来]的(经理)}	我是 新来 的	我是_新来_的_经理
我是{新来的(翻译)}	我是 新来的	我是_新来的_翻译
他[现在]在(学校)	他 现在 在	他_现在_在_学校
他现在在(机场)	他现在在	他现在在_机场
他们现在在(医院)	他们现在在	他们现在在_医院
你{很[和蔼]} (m) % 你们{很[和蔼]} (p)	你 很 和蔼%你们 很 和蔼	你_很_和蔼_m%你们_很_和蔼_p
她{很[漂亮]}	她 很 漂亮	她_很_漂亮
我们{(非常)[快乐]}	我们 快乐	我们_非常_快乐
{我們的(邻居)}非常[草腦]	我們的 非常 草腦	我們的_邻居_非常_草腦
{我的(朋友)}很[聰明]	我的 很 聰明	我的_朋友_很_聰明
{我們的(同事)}很[安靜]	我們的 很 安靜	我們的_同事_很_安靜
{大部分的(人)}很[和藹]	大部分的 很 和藹	大部分的_人_很_和藹
{大部分的(小孩)}很[聰明]	大部分的 很 聰明	大部分的_小孩_很_聰明
{大部分的(書)}是新的	大部分的 是新的	大部分的_書_是新的
我從{[另外]一個(國家)}來	我從 另外 一個 來	我從_另外_一個_國家_來
他從{另外一個(地方)}來	他從 另外一個 來	他從_另外一個_地方_來
他們從{另外一個(塵世)}來	他們從 另外一個 來	他們從_另外一個_塵世_來
{這個(書)}不[好]	這個 不 好	這個_書_不_好
{這個(食物)}不[干淨]	這個 不 干淨	這個_食物_不_干淨
{這個(公共汽車)}不錯	這個 不錯	這個_公共汽車_不錯
{非常感謝你}的[幫忙]！(不客氣)	非常感謝你 的 幫忙	非常感謝你_的_幫忙_不客氣
謝謝您情我吃{[好]吃的(食物)}！不客氣	謝謝您情我吃 好 吃的 不客氣	謝謝您情我吃_好_吃的_食物_不客氣
[謝謝你]想的{這(注意)}！ 不客氣	謝謝你 想的 這 不客氣	謝謝你_想的_這_注意_不客氣
{[對不起]打擾你}。 (沒關係)	對不起 打擾你	對不起_打擾你_沒關係
{對不起(這樣做)}。沒關係	對不起 沒關係	對不起_這樣做_沒關係
對不起問這(問題)。 沒關係	對不起問這 沒關係	對不起問這_問題_沒關係
{你還好嗎}？[我還好]，(謝謝)	你還好嗎 我還好	你還好嗎_我還好_謝謝
你(現在)好嗎？{[好多]了}，謝謝	你好嗎 好多 了 謝謝	你_現在_好嗎_好多_了_謝謝
{你好}！[(我的名字)是Adam]	你好 是adam	你好_我的名字_是adam
你好！{你叫甚麼[名字]}？	你好 你叫甚麼 名字	你好_你叫甚麼_名字
你好！{你從哪裡來}？	你好 你從哪裡來	你好_你從哪裡來
[對不起]，{你可以幫我嗎}？	對不起 你可以幫我嗎	對不起_你可以幫我嗎
對不起，{你可不可以讓我看一下(這東西)}？	對不起 你可不可以讓我看一下	對不起_你可不可以讓我看一下_這東西
對不起，你{可以(慢慢)說嗎}？	對不起 你 可以說嗎	對不起_你_可以_慢慢_說嗎
情{給我(一點[食物])}	情 給我	情_給我_一點_食物
[情]給我{一點[水]}	情 給我 一點 水	情_給我_一點_水
情給我[一個(地方)睡覺]	情給我 一個睡覺	情給我_一個_地方_睡覺
這是{我的[電話](號碼)}	這是 我的 電話	這是_我的_電話_號碼
這是{我[新]的(地址)}	這是 我 新 的	這是_我_新_的_地址
這是{我的[湖造]}	這是 我的 湖造	這是_我的_湖造
{[廁所]}在哪裡?	廁所 在哪裡	廁所_在哪裡
{[你]家}在哪裡?	你 家 在哪裡	你_家_在哪裡
{我的[房間]}在哪裡?	我的 房間 在哪裡	我的_房間_在哪裡
我可不可以{打一個[電話]}?	我可不可以 打一個 電話	我可不可以_打一個_電話
你可不可以幫助我?	你可不可以幫助我	你可不可以幫助我
		
		
		
		
		
		
		
		
		
		
		
		
		
		
		
		
		
		
		
		
		
		
		
		
		
		
		
		
		
		
		
		
		
		
		
		
		
		
		
		
		
		
		
		
		
		
		
		
		
		
		
		
		
		
		
		
		
		
		
		
		
		
		
		
		
		
		
		
		
		
		
		
		
		
		
		
		
		
		
		
		
		
		
		
		
		
		
		
		
		
		
		
		
		
		
		
		
		
		
		
		
		
		
		
		
		
		
		
		
		
		
		
		
		