一个男人	一个男人	一个男人
男人	男人	男人
{这个男人}	这个男人	这个男人
他很聪明	他很聪明	他很聪明
这个 男人 很 聪明	这个 男人 很 聪明	这个_男人_很_聪明
他 很 好	他 很 好	他_很_好
这个 男人 很 好	这个 男人 很 好	这个_男人_很_好
他很高	他很高	他很高
这个男子很高	这个男子很高	这个男子很高
一个聪明的人	一个聪明的人	一个聪明的人
这个 聪明 的 男人	这个 聪明 的 男人	这个_聪明_的_男人
一个 好 男人	一个 好 男人	一个_好_男人
这个 好 男人	这个 好 男人	这个_好_男人
一个高的男子	一个高的男子	一个高的男子
这个高的男人	这个高的男人	这个高的男人
他 读	他 读	他_读
这个 男人 读	这个 男人 读	这个_男人_读
他 吃	他 吃	他_吃
这个 男人 吃	这个 男人 吃	这个_男人_吃
他 喝	他 喝	他_喝
这个 男人 喝	这个 男人 喝	这个_男人_喝
他 唱	他 唱	他_唱
唱 的 男人	唱 的 男人	唱_的_男人
他 煮	他 煮	他_煮
煮 的 男人	煮 的 男人	煮_的_男人
他 游泳	他 游泳	他_游泳
游泳 的 男人	游泳 的 男人	游泳_的_男人
他 是 一个 老师	他 是 一个 老师	他_是_一个_老师
这个 男人 是 一个 老师	这个 男人 是 一个 老师	这个_男人_是_一个_老师
他 是 一个 医生	他 是 一个 医生	他_是_一个_医生
这个 男人 是 一个 医生	这个 男人 是 一个 医生	这个_男人_是_一个_医生
他 是 一个 翻译	他 是 一个 翻译	他_是_一个_翻译
这个 男人 是 一个 翻译	这个 男人 是 一个 翻译	这个_男人_是_一个_翻译
我 的 父亲	我 的 父亲	我_的_父亲
他 的 父亲	他 的 父亲	他_的_父亲
她 的 父亲	她 的 父亲	她_的_父亲
你 的 父亲（s）％，你们 的 父亲（p） % 您 的 父亲 (r)	你 的 父亲 s 你们 的 父亲 p%您 的 父亲	你_的_父亲_s_你们_的_父亲_p%您_的_父亲_r
我 的 父亲 是 一个 老师	我 的 父亲 是 一个 老师	我_的_父亲_是_一个_老师
他 的 父亲 是 一个 医生	他 的 父亲 是 一个 医生	他_的_父亲_是_一个_医生
她 的 父亲 是 一个 翻译	她 的 父亲 是 一个 翻译	她_的_父亲_是_一个_翻译
我 的 父亲 是 一个 医生	我 的 父亲 是 一个 医生	我_的_父亲_是_一个_医生
你 的 父亲 是 一个 老师（s）％ 你们 的 父亲 是 一个 老师（p）% 您 的 父亲 是 一个 老师 (r)	你 的 父亲 是 一个 老师 s 你们 的 父亲 是 一个 老师 p%您 的 父亲 是 一个 老师	你_的_父亲_是_一个_老师_s_你们_的_父亲_是_一个_老师_p%您_的_父亲_是_一个_老师_r
一个猫	一个猫	一个猫
猫	猫	猫
这个 猫	这个 猫	这个_猫
我 的 猫	我 的 猫	我_的_猫
你 的 猫（s）％，你们 的 猫（p）% 您 的 猫 (r)	你 的 猫 s 你们 的 猫 p%您 的 猫	你_的_猫_s_你们_的_猫_p%您_的_猫_r
我们 的 猫	我们 的 猫	我们_的_猫
他 的 猫	他 的 猫	他_的_猫
她 的 猫	她 的 猫	她_的_猫
他们 的 猫	他们 的 猫	他们_的_猫
一个 大 猫	一个 大 猫	一个_大_猫
我 的 猫 是 大	我 的 猫 是 大	我_的_猫_是_大
一个 黑 猫	一个 黑 猫	一个_黑_猫
他 的 猫 是 黑色	他 的 猫 是 黑色	他_的_猫_是_黑色
 小猫	小猫	小猫
她 的 猫 是 小	她 的 猫 是 小	她_的_猫_是_小
一个狗	一个狗	一个狗
狗	狗	狗
这个 狗	这个 狗	这个_狗
我 的 狗	我 的 狗	我_的_狗
我 父亲 的 狗	我 父亲 的 狗	我_父亲_的_狗
他 的 狗	他 的 狗	他_的_狗
他 父亲 的 狗	他 父亲 的 狗	他_父亲_的_狗
她 的 狗	她 的 狗	她_的_狗
她 父亲 的 狗	她 父亲 的 狗	她_父亲_的_狗
一个 包包	一个 包包	一个_包包
包包	包包	包包
这个 包包	这个 包包	这个_包包
我要一个包包	我要一个包包	我要一个包包
他要一个背包	他要一个背包	他要一个背包
我要一个车	我要一个车	我要一个车
他要一 辆车	他要一 辆车	他要一_辆车
我要一个房子	我要一个房子	我要一个房子
他 要 一个 房子	他 要 一个 房子	他_要_一个_房子
一个女人	一个女人	一个女人
女人	女人	女人
{这个女人}	这个女人	这个女人
她要一个车	她要一个车	她要一个车
这个女人要一个车	这个女人要一个车	这个女人要一个车
她 要 一个 包包	她 要 一个 包包	她_要_一个_包包
这个女人要一个包包	这个女人要一个包包	这个女人要一个包包
她要一个房子	她要一个房子	她要一个房子
这个 女人 要 一个 房子	这个 女人 要 一个 房子	这个_女人_要_一个_房子
一个 房子	一个 房子	一个_房子
房子	房子	房子
这个 房子	这个 房子	这个_房子
{一个[新](房子)}	一个 新	一个_新_房子
这个 房子 是 新 的	这个 房子 是 新 的	这个_房子_是_新_的
{一个[旧]房子}	一个 旧 房子	一个_旧_房子
这个 房子 是 旧 的	这个 房子 是 旧 的	这个_房子_是_旧_的
一个 好 的 房子	一个 好 的 房子	一个_好_的_房子
这个 房子 是 好 的	这个 房子 是 好 的	这个_房子_是_好_的
我们要一个房子	我们要一个房子	我们要一个房子
我们 要 一个 新 的 房子	我们 要 一个 新 的 房子	我们_要_一个_新_的_房子
他们 要 一个 房子	他们 要 一个 房子	他们_要_一个_房子
他们 要 一个 新 的 房子	他们 要 一个 新 的 房子	他们_要_一个_新_的_房子
我们 要 一个 好 的 房子	我们 要 一个 好 的 房子	我们_要_一个_好_的_房子
他们 要 一个 好 的 房子	他们 要 一个 好 的 房子	他们_要_一个_好_的_房子
什么?	什么	什么
哪里?	哪里	哪里
几点?	几点	几点
谁?	谁	谁
为什么?	为什么	为什么
怎么样?	怎么样	怎么样
多少?	多少	多少
男人	男人	男人
男人	男人	男人
这些 男人	这些 男人	这些_男人
你 要 什么（s）％ 你们 要 什么 （p）% 您 要 什么 (r)	你 要 什么 s 你们 要 什么 p%您 要 什么	你_要_什么_s_你们_要_什么_p%您_要_什么_r
她 要 什么	她 要 什么	她_要_什么
这个 女人 要 什么	这个 女人 要 什么	这个_女人_要_什么
他 要 什么	他 要 什么	他_要_什么
这个 男人 要 什么	这个 男人 要 什么	这个_男人_要_什么
他们 要 什么	他们 要 什么	他们_要_什么
这些 男人 要 什么	这些 男人 要 什么	这些_男人_要_什么
汤	汤	汤
饭	饭	饭
面	面	面
面包	面包	面包
沙拉	沙拉	沙拉
起司	起司	起司
鸡	鸡	鸡
肉	肉	肉
蔬菜	蔬菜	蔬菜
鱼	鱼	鱼
水果	水果	水果
猪肉	猪肉	猪肉
他	他	他
她	她	她
我	我	我
我们	我们	我们
他们	他们	他们
你 (s) % 你们 (p) % 您 (r)	你%你们%您	你_s%你们_p%您_r
他	他	他
这 是 什么	这 是 什么	这_是_什么
怎 样 了	怎 样 了	怎_样_了
还 有 什么	还 有 什么	还_有_什么
怎么了	怎么了	怎么了
我 要 吃	我 要 吃	我_要_吃
她 要 吃	她 要 吃	她_要_吃
我 要 喝	我 要 喝	我_要_喝
她 要 喝	她 要 喝	她_要_喝
我 要 读	我 要 读	我_要_读
她 要 读	她 要 读	她_要_读
我 吃	我 吃	我_吃
我们 吃	我们 吃	我们_吃
她 吃	她 吃	她_吃
你 吃（S）％，你们 吃（P）% 您 吃 (r)	你 吃 s 你们 吃 p%您 吃	你_吃_s_你们_吃_p%您_吃_r
他们 吃	他们 吃	他们_吃
我吃麵食	我吃麵食	我吃麵食
他 吃 面	他 吃 面	他_吃_面
她 吃 水果	她 吃 水果	她_吃_水果
我们 吃 鱼	我们 吃 鱼	我们_吃_鱼
他们 吃 起司	他们 吃 起司	他们_吃_起司
你 吃 鸡肉（P）％你们 吃 鸡肉（P）% 您 吃 鸡肉 (r)	你 吃 鸡肉 p 你们 吃 鸡肉 p%您 吃 鸡肉	你_吃_鸡肉_p_你们_吃_鸡肉_p%您_吃_鸡肉_r
我 不 吃 肉	我 不 吃 肉	我_不_吃_肉
她 不 吃 肉	她 不 吃 肉	她_不_吃_肉
我 不 吃 猪肉	我 不 吃 猪肉	我_不_吃_猪肉
她 不 吃 猪肉	她 不 吃 猪肉	她_不_吃_猪肉
他们 不 吃 鱼	他们 不 吃 鱼	他们_不_吃_鱼
他们 不 吃 起司	他们 不 吃 起司	他们_不_吃_起司
他 不 吃 面	他 不 吃 面	他_不_吃_面
他 不 吃 水果	他 不 吃 水果	他_不_吃_水果
你 做 什么 （s）％ 你们 做 什么 （p）% 您 做 什么 (r)	你 做 什么 s 你们 做 什么 p%您 做 什么	你_做_什么_s_你们_做_什么_p%您_做_什么_r
你 说 什么 (s）％ 你们 说 什么（p）% 您 什么 (r)	你 说 什么 s 你们 说 什么 p%您 什么	你_说_什么_s_你们_说_什么_p%您_什么_r
她 做 什么	她 做 什么	她_做_什么
她 说 什么	她 说 什么	她_说_什么
他 做 什么	他 做 什么	他_做_什么
他 说 什么	他 说 什么	他_说_什么
你 是 谁 （s）％你们 是 谁 （p） % 您 是 谁 (r)	你 是 谁 s 你们 是 谁 p%您 是 谁	你_是_谁_s_你们_是_谁_p%您_是_谁_r
他 是 谁	他 是 谁	他_是_谁
谁 是 这个 男人	谁 是 这个 男人	谁_是_这个_男人
她 是 谁	她 是 谁	她_是_谁
谁 是 这个 女人	谁 是 这个 女人	谁_是_这个_女人
他们 是 谁	他们 是 谁	他们_是_谁
谁 是 这些 男人	谁 是 这些 男人	谁_是_这些_男人
我 说 英语	我 说 英语	我_说_英语
她 说 英语	她 说 英语	她_说_英语
我们 说 英语	我们 说 英语	我们_说_英语
他们 说 英语	他们 说 英语	他们_说_英语
你 说 英语（s）％ 你们 说 英语（p）% 您 说 英语 (r)	你 说 英语 s 你们 说 英语 p%您 说 英语	你_说_英语_s_你们_说_英语_p%您_说_英语_r
他 说 英语	他 说 英语	他_说_英语
人	人	人
人	人	人
这些 人	这些 人	这些_人
我 不 说 英语	我 不 说 英语	我_不_说_英语
她 不 说 英语	她 不 说 英语	她_不_说_英语
这个 女人 不 说 英语	这个 女人 不 说 英语	这个_女人_不_说_英语
他 不 说 英语	他 不 说 英语	他_不_说_英语
这个 男人 不 说 英语	这个 男人 不 说 英语	这个_男人_不_说_英语
他们 不 说 英语	他们 不 说 英语	他们_不_说_英语
这些 人 不 说 英语	这些 人 不 说 英语	这些_人_不_说_英语
你 说 英语 吗 (s) % 你们 说 英语 吗 (p) % 您 说 英语 吗 (r)	你 说 英语 吗%你们 说 英语 吗%您 说 英语 吗	你_说_英语_吗_s%你们_说_英语_吗_p%您_说_英语_吗_r
她 说 英语 吗	她 说 英语 吗	她_说_英语_吗
这个 女人 说 英语 吗	这个 女人 说 英语 吗	这个_女人_说_英语_吗
他 说 英语 吗	他 说 英语 吗	他_说_英语_吗
这个 男人 说 英语 吗	这个 男人 说 英语 吗	这个_男人_说_英语_吗
他们 说 英语 吗	他们 说 英语 吗	他们_说_英语_吗
这些 人 说 英语 吗	这些 人 说 英语 吗	这些_人_说_英语_吗
我 的 名字	我 的 名字	我_的_名字
他 的 名字	他 的 名字	他_的_名字
她 的 名字	她 的 名字	她_的_名字
你 的 名字 (s) % 你们 的 名字 (p) % 您 的 名字 (r)	你 的 名字%你们 的 名字%您 的 名字	你_的_名字_s%你们_的_名字_p%您_的_名字_r
你 的 名字 是 什么 (s) % 你们 的 名字 是 什么 (p) % 您 的 名字 是 什么 (r)	你 的 名字 是 什么%你们 的 名字 是 什么%您 的 名字 是 什么	你_的_名字_是_什么_s%你们_的_名字_是_什么_p%您_的_名字_是_什么_r
他 的 名字 是 什么	他 的 名字 是 什么	他_的_名字_是_什么
她 的 名字 是 什么	她 的 名字 是 什么	她_的_名字_是_什么
地址	地址	地址
我 的 地址	我 的 地址	我_的_地址
你 的 地址（s）％ 你们 的 地址 (p) % 您 的 地址 (r)	你 的 地址 s 你们 的 地址%您 的 地址	你_的_地址_s_你们_的_地址_p%您_的_地址_r
他 的 地址	他 的 地址	他_的_地址
她 的 地址	她 的 地址	她_的_地址
我们 的 地址	我们 的 地址	我们_的_地址
他们 的 地址	他们 的 地址	他们_的_地址
我 知道 他 的 名字	我 知道 他 的 名字	我_知道_他_的_名字
我 知道 他 的 地址	我 知道 他 的 地址	我_知道_他_的_地址
他 知道 我 的 地址	他 知道 我 的 地址	他_知道_我_的_地址
他 知道 我 的 名字	他 知道 我 的 名字	他_知道_我_的_名字
她 知道 他们 的 地址	她 知道 他们 的 地址	她_知道_他们_的_地址
她 知道 他 的 名字	她 知道 他 的 名字	她_知道_他_的_名字
这个 女人 知道 我 的 地址	这个 女人 知道 我 的 地址	这个_女人_知道_我_的_地址
他们 知道 我们 的 地址	他们 知道 我们 的 地址	他们_知道_我们_的_地址
这些 人 知道 他 的 名字	这些 人 知道 他 的 名字	这些_人_知道_他_的_名字
我 不 知道	我 不 知道	我_不_知道
他 不 知道	他 不 知道	他_不_知道
这个 男人 不 知道	这个 男人 不 知道	这个_男人_不_知道
她 不 知道	她 不 知道	她_不_知道
这个 女人 不 知道	这个 女人 不 知道	这个_女人_不_知道
他们 不 知道	他们 不 知道	他们_不_知道
这些 人 不 知道	这些 人 不 知道	这些_人_不_知道
我 的 母亲	我 的 母亲	我_的_母亲
你 的 母亲（s）％你们 的 母亲（p）% 您 的 母亲 (r)	你 的 母亲 s 你们 的 母亲 p%您 的 母亲	你_的_母亲_s_你们_的_母亲_p%您_的_母亲_r
他 的	他 的	他_的
 母亲	母亲	母亲
我 会 游泳	我 会 游泳	我_会_游泳
他 会 游泳	他 会 游泳	他_会_游泳
我 的 父亲 会 游泳	我 的 父亲 会 游泳	我_的_父亲_会_游泳
她 会 游泳	她 会 游泳	她_会_游泳
我 的 母亲 会 游泳	我 的 母亲 会 游泳	我_的_母亲_会_游泳
你 会 游泳（s）％你们 会 游泳（p）% 您 会 游泳 (r)	你 会 游泳 s 你们 会 游泳 p%您 会 游泳	你_会_游泳_s_你们_会_游泳_p%您_会_游泳_r
我们 会 游泳	我们 会 游泳	我们_会_游泳
他们 会 游泳	他们 会 游泳	他们_会_游泳
这些 人 会 游泳	这些 人 会 游泳	这些_人_会_游泳
一个 问题	一个 问题	一个_问题
问题	问题	问题
这个 问题	这个 问题	这个_问题
我 的 问题	我 的 问题	我_的_问题
他	他	他
 的 问题	的 问题	的_问题
她 的 问题	她 的 问题	她_的_问题
你 的 问题（s）％你们 的 问题 (p) % 您 的 问题（r）	你 的 问题 s 你们 的 问题%您 的 问题 r	你_的_问题_s_你们_的_问题_p%您_的_问题_r
我们 的 问题	我们 的 问题	我们_的_问题
一个汽车	一个汽车	一个汽车
一个 车	一个 车	一个_车
这个 车	这个 车	这个_车
我 有 一个 房子	我 有 一个 房子	我_有_一个_房子
我 有 一个 车	我 有 一个 车	我_有_一个_车
他 有 一个 房子	他 有 一个 房子	他_有_一个_房子
他 有 一个 车	他 有 一个 车	他_有_一个_车
她有一个猫	她有一个猫	她有一个猫
他 有 一个 房子	他 有 一个 房子	他_有_一个_房子
他 有 一个 猫	他 有 一个 猫	他_有_一个_猫
他们 有 一个 车	他们 有 一个 车	他们_有_一个_车
他们 有 一个 房子	他们 有 一个 房子	他们_有_一个_房子
我们有一个猫	我们有一个猫	我们有一个猫
我们 有 一个 房子	我们 有 一个 房子	我们_有_一个_房子
我 没 有 一个 房子	我 没 有 一个 房子	我_没_有_一个_房子
我 没 有 一个 车	我 没 有 一个 车	我_没_有_一个_车
他 没 有 一个 房子	他 没 有 一个 房子	他_没_有_一个_房子
她 没 有 一个 车	她 没 有 一个 车	她_没_有_一个_车
她 没 有 一个 猫	她 没 有 一个 猫	她_没_有_一个_猫
他 没 有 一个 房子	他 没 有 一个 房子	他_没_有_一个_房子
他 没 有 一个 猫	他 没 有 一个 猫	他_没_有_一个_猫
他们 没 有 一个 车	他们 没 有 一个 车	他们_没_有_一个_车
他们 没 有 一个 房子	他们 没 有 一个 房子	他们_没_有_一个_房子
我们 没 有 一个 猫	我们 没 有 一个 猫	我们_没_有_一个_猫
我们 没 有 一个 房子	我们 没 有 一个 房子	我们_没_有_一个_房子
真 的 吗	真 的 吗	真_的_吗
确定 吗	确定 吗	确定_吗
你 呢? (s) % 你们 呢 (p) % 您 呢 (r)	你 呢%你们 呢%您 呢	你_呢_s%你们_呢_p%您_呢_r
完 了 吗	完 了 吗	完_了_吗
对 吗	对 吗	对_吗
早安	早安	早安
晚安	晚安	晚安
你 好 （s）％ 你们 好（p）% 您 好 (r)	你 好 s 你们 好 p%您 好	你_好_s_你们_好_p%您_好_r
欢迎	欢迎	欢迎
谢谢	谢谢	谢谢
不 客气	不 客气	不_客气
抱歉	抱歉	抱歉
对不起!	对不起	对不起
没关系	没关系	没关系
再见	再见	再见
这 给 你 (b) % 这 给 你们 (p) % 这 给 您 (r)	这 给 你%这 给 你们%这 给 您	这_给_你_b%这_给_你们_p%这_给_您_r
“请	请	请
你 从 哪里 来 (s) % 你们 从 哪里 来 (p) % 您 从 哪里 来 (r)	你 从 哪里 来%你们 从 哪里 来%您 从 哪里 来	你_从_哪里_来_s%你们_从_哪里_来_p%您_从_哪里_来_r
你 在 哪里 (s) % 你们 在 那里 (p) % 您 在 那里 (r)	你 在 哪里%你们 在 那里%您 在 那里	你_在_哪里_s%你们_在_那里_p%您_在_那里_r
他 在 那里	他 在 那里	他_在_那里
她 在 那里	她 在 那里	她_在_那里
我们 在 那里	我们 在 那里	我们_在_那里
他们 在 那里	他们 在 那里	他们_在_那里
我在那里?	我在那里	我在那里
现在	现在	现在
今天	今天	今天
明天	明天	明天
昨天	昨天	昨天
过一会儿	过一会儿	过一会儿
下个 星期	下个 星期	下个_星期
上个 星期	上个 星期	上个_星期
下个 月	下个 月	下个_月
上个 月	上个 月	上个_月
有时	有时	有时
总是	总是	总是
常常	常常	常常
很少	很少	很少
对	对	对
不	不	不
当然	当然	当然
不 确定	不 确定	不_确定
还没	还没	还没
有 可能	有 可能	有_可能
好	好	好
我 不 觉得	我 不 觉得	我_不_觉得
不 知道	不 知道	不_知道
没 问题	没 问题	没_问题
随便	随便	随便
有 一个 问题	有 一个 问题	有_一个_问题
有 一个 问题	有 一个 问题	有_一个_问题
暴风雨	暴风雨	暴风雨
有 暴风雨	有 暴风雨	有_暴风雨
一个 主意	一个 主意	一个_主意
另外 一个 主意	另外 一个 主意	另外_一个_主意
一个火车	一个火车	一个火车
另外 一个 火车	另外 一个 火车	另外_一个_火车
一个 电影	一个 电影	一个_电影
另外 一个 电影	另外 一个 电影	另外_一个_电影
男孩	男孩	男孩
一些 男孩	一些 男孩	一些_男孩
女孩	女孩	女孩
一些 女孩	一些 女孩	一些_女孩
车	车	车
一些 车	一些 车	一些_车
有人	有人	有人
某物	某物	某物
没有人	没有人	没有人
没什么	没什么	没什么
大家	大家	大家
一切	一切	一切
等等	等等	等等
来	来	来
走	走	走
留着	留着	留着
离开	离开	离开
看	看	看
听	听	听
记住	记住	记住
读	读	读
看	看	看
抓住	抓住	抓住
我 爱 你	我 爱 你	我_爱_你
他 爱 她	他 爱 她	他_爱_她
她 爱 他	她 爱 他	她_爱_他
他们 爱 她	他们 爱 她	他们_爱_她
这些 人 爱 她	这些 人 爱 她	这些_人_爱_她
这些 人 爱 他	这些 人 爱 他	这些_人_爱_他
我们 爱 他	我们 爱 他	我们_爱_他
他 爱 他们	他 爱 他们	他_爱_他们
这些 人 爱 他们	这些 人 爱 他们	这些_人_爱_他们
		
		
		
		
		
		
		
		
		
		
		
		
		
		
		
		
		
		
		
		
		
		
		
		
		
		
		
		
		
		
		
		
		
		
		
		
		
		
		
		
		
		
		
		
		
一个高的老师	一个高的老师	一个高的老师
一个聪明的老师	一个聪明的老师	一个聪明的老师
聪明的老师	聪明的老师	聪明的老师
高的男人	高的男人	高的男人
这个聪明的老师	这个聪明的老师	这个聪明的老师
这个老师很聪明	这个老师很聪明	这个老师很聪明
这个高的老师	这个高的老师	这个高的老师
这个老师很高	这个老师很高	这个老师很高
这个高的老师很聪明	这个高的老师很聪明	这个高的老师很聪明
这个聪明的男子很高	这个聪明的男子很高	这个聪明的男子很高
早安！ <br> 早安。	早安 br 早安	早安_br_早安
晚安！ <br> 晚安。	晚安 br 晚安	晚安_br_晚安
你好吗？ <br> 我好，谢谢。	你好吗 br 我好 谢谢	你好吗_br_我好_谢谢
谢谢！ <br> 不客气。	谢谢 br 不客气	谢谢_br_不客气
你的名字是什麽？ <br>我的名字是Adam。	你的名字是什麽 br 我的名字是adam	你的名字是什麽_br_我的名字是adam
一个公共汽车	一个公共汽车	一个公共汽车
一个飞机	一个飞机	一个飞机
一个船	一个船	一个船
我有一个狗	我有一个狗	我有一个狗
我有一个猫	我有一个猫	我有一个猫
我有一个马	我有一个马	我有一个马
我们有一个马	我们有一个马	我们有一个马
她有一个狗	她有一个狗	她有一个狗
他有一个狗	他有一个狗	他有一个狗
他有一个马	他有一个马	他有一个马
这个老师有一个马	这个老师有一个马	这个老师有一个马
这个老师有一个狗	这个老师有一个狗	这个老师有一个狗
你有一个狗	你有一个狗	你有一个狗
你有一个猫	你有一个猫	你有一个猫
一个鱼	一个鱼	一个鱼
一个牛	一个牛	一个牛
一个鸟	一个鸟	一个鸟
你从哪里来？ <BR> 我从法国来。	你从哪里来 br 我从法国来	你从哪里来_br_我从法国来
你你几岁？ <BR>我二十岁。	你你几岁 br 我二十岁	你你几岁_br_我二十岁
你要什麽？ <BR> 我想吃饭。	你要什麽 br 我想吃饭	你要什麽_br_我想吃饭
你在找什麽？ <BR>我在找餐厅。	你在找什麽 br 我在找餐厅	你在找什麽_br_我在找餐厅
一个男孩	一个男孩	一个男孩
一个女孩	一个女孩	一个女孩
我们要一个车	我们要一个车	我们要一个车
这个男人要一个房子	这个男人要一个房子	这个男人要一个房子
这个男人要一个车	这个男人要一个车	这个男人要一个车
你要一个车	你要一个车	你要一个车
你要一个房子	你要一个房子	你要一个房子
{一个[小](问题)}	一个 小	一个_小_问题
{一个[大](问题)}	一个 大	一个_大_问题
{[另外]一个问题}	另外 一个问题	另外_一个问题
{一个[大](房子)}	一个 大	一个_大_房子
{[其他](问题)}	其他	其他_问题
{[好]的问题}	好 的问题	好_的问题
{[许多]问题}	许多 问题	许多_问题
[一部旧车]	一部旧车	一部旧车
[一部好车]	一部好车	一部好车
{一部[新](车)}	一部 新	一部_新_车
{这个人}	这个人	这个人
{我的[电话](号码)}	我的 电话	我的_电话_号码
{我[新]的(地址)}	我 新 的	我_新_的_地址
{我的[护照]}	我的 护照	我的_护照
信来了	信来了	信来了
人来了	人来了	人来了
客人来了	客人来了	客人来了
他想要一张票	他想要一张票	他想要一张票
我吃鸡	我吃鸡	我吃鸡
我吃奶酪	我吃奶酪	我吃奶酪
我看到公共汽车了	我看到公共汽车了	我看到公共汽车了
我看到火车了	我看到火车了	我看到火车了
我看到飞机了	我看到飞机了	我看到飞机了
我有{一个[小](问题)}	我有 一个 小	我有_一个_小_问题
我们有{一个[大](问题)}	我们有 一个 大	我们有_一个_大_问题
他有{[另外]一个问题}	他有 另外 一个问题	他有_另外_一个问题
我们有{一个[大](房子)}	我们有 一个 大	我们有_一个_大_房子
她有{一个[新](房子)}	她有 一个 新	她有_一个_新_房子
他们有{一个[旧]房子}	他们有 一个 旧 房子	他们有_一个_旧_房子
你有{[其他](问题)}	你有 其他	你有_其他_问题
他们有{[好]的问题}	他们有 好 的问题	他们有_好_的问题
我们有{[许多]问题}	我们有 许多 问题	我们有_许多_问题
{这个(女人)}有一个新[厨房]	这个 有一个新 厨房	这个_女人_有一个新_厨房
{这个(男人)}有[一辆旧车]	这个 有 一辆旧车	这个_男人_有_一辆旧车
{这个(人)}有[一辆好车]	这个 有 一辆好车	这个_人_有_一辆好车
他没有{一辆[新](车)}	他没有 一辆 新	他没有_一辆_新_车
他们没有{[其他]的(问题)}	他们没有 其他 的	他们没有_其他_的_问题
我们没有{[任何]问题}	我们没有 任何 问题	我们没有_任何_问题
{这个女人}没有[一辆好车]	这个女人 没有 一辆好车	这个女人_没有_一辆好车
{这个男人}没有[一辆旧车]	这个男人 没有 一辆旧车	这个男人_没有_一辆旧车
{这个人}没有[一辆新车]	这个人 没有 一辆新车	这个人_没有_一辆新车
我是{[新来]的(老师)}	我是 新来 的	我是_新来_的_老师
我是{[新来]的(经理)}	我是 新来 的	我是_新来_的_经理
我是{新来的(翻译)}	我是 新来的	我是_新来的_翻译
他[现在]在(学校)	他 现在 在	他_现在_在_学校
他现在在(机场)	他现在在	他现在在_机场
他们现在在(医院)	他们现在在	他们现在在_医院
你{很[和蔼]} (m) % 你们{很[和蔼]} (p)	你 很 和蔼%你们 很 和蔼	你_很_和蔼_m%你们_很_和蔼_p
她{很[漂亮]}	她 很 漂亮	她_很_漂亮
我们{(非常)[快乐]}	我们 快乐	我们_非常_快乐
{我们的(邻居)}非常[草脑]	我们的 非常 草脑	我们的_邻居_非常_草脑
{我的(朋友)}很[聪明]	我的 很 聪明	我的_朋友_很_聪明
{我们的(同事)}很[安静]	我们的 很 安静	我们的_同事_很_安静
{大部分的(人)}很[和蔼]	大部分的 很 和蔼	大部分的_人_很_和蔼
{大部分的(小孩)}很[聪明]	大部分的 很 聪明	大部分的_小孩_很_聪明
{大部分的(书)}是新的	大部分的 是新的	大部分的_书_是新的
我从{[另外]一个(国家)}来	我从 另外 一个 来	我从_另外_一个_国家_来
他从{另外一个(地方)}来	他从 另外一个 来	他从_另外一个_地方_来
他们从{另外一个(尘世)}来	他们从 另外一个 来	他们从_另外一个_尘世_来
{这个(书)}不[好]	这个 不 好	这个_书_不_好
{这个(食物)}不[干净]	这个 不 干净	这个_食物_不_干净
{这个(公共汽车)}不错	这个 不错	这个_公共汽车_不错
{非常感谢你}的[帮忙]！(不客气)	非常感谢你 的 帮忙	非常感谢你_的_帮忙_不客气
谢谢您情我吃{[好]吃的(食物)}！不客气	谢谢您情我吃 好 吃的 不客气	谢谢您情我吃_好_吃的_食物_不客气
[谢谢你]想的{这(注意)}！ 不客气	谢谢你 想的 这 不客气	谢谢你_想的_这_注意_不客气
{[对不起]打扰你}。 (没关係)	对不起 打扰你	对不起_打扰你_没关係
{对不起(这样做)}。没关係	对不起 没关係	对不起_这样做_没关係
对不起问这(问题)。 没关係	对不起问这 没关係	对不起问这_问题_没关係
{你还好吗}？[我还好]，(谢谢)	你还好吗 我还好	你还好吗_我还好_谢谢
你(现在)好吗？{[好多]了}，谢谢	你好吗 好多 了 谢谢	你_现在_好吗_好多_了_谢谢
{你好}！[(我的名字)是Adam]	你好 是adam	你好_我的名字_是adam
你好！{你叫甚麽[名字]}？	你好 你叫甚麽 名字	你好_你叫甚麽_名字
你好！{你从哪里来}？	你好 你从哪里来	你好_你从哪里来
[对不起]，{你可以帮我吗}？	对不起 你可以帮我吗	对不起_你可以帮我吗
对不起，{你可不可以让我看一下(这东西)}？	对不起 你可不可以让我看一下	对不起_你可不可以让我看一下_这东西
对不起，你{可以(慢慢)说吗}？	对不起 你 可以说吗	对不起_你_可以_慢慢_说吗
情{给我(一点[食物])}	情 给我	情_给我_一点_食物
[情]给我{一点[水]}	情 给我 一点 水	情_给我_一点_水
情给我[一个(地方)睡觉]	情给我 一个睡觉	情给我_一个_地方_睡觉
这是{我的[电话](号码)}	这是 我的 电话	这是_我的_电话_号码
这是{我[新]的(地址)}	这是 我 新 的	这是_我_新_的_地址
这是{我的[湖造]}	这是 我的 湖造	这是_我的_湖造
{[厕所]}在哪里?	厕所 在哪里	厕所_在哪里
{[你]家}在哪里?	你 家 在哪里	你_家_在哪里
{我的[房间]}在哪里?	我的 房间 在哪里	我的_房间_在哪里
我可不可以{打一个[电话]}?	我可不可以 打一个 电话	我可不可以_打一个_电话
你可不可以帮助我?	你可不可以帮助我	你可不可以帮助我
		
		
		
		
		
		
		
		
		
		
		
		
		
		
		
		
		
		
		
		
		
		
		
		
		
		
		
		
		
		
		
		
		
		
		
		
		
		
		
		
		
		
		
		
		
		
		
		
		
		
		
		
		
		
		
		
		
		
		
		
		
		
		
		
		
		
		
		
		
		
		
		
		
		
		
		
		
		
		
		
		
		
		
		
		
		
		
		
		
		
		
		
		
		
		
		
		
		
		
		
		
		
		
		
		
		
		
		
		
		
		
		
		
		